Rollover Text	Right-Click Text																						
"Note: Do not change the headings in this file, they are used to detect problems"																							
Menu principal																							
	"{Novo jogo}

Começar um jogo novo."																						
	"{Carregar jogo}

Carregar um jogo salvo."																						
	"{High Scores}

View the legendary Heroes of Might and Magic."																						
	"{Créditos}

Ver os créditos do jogo."																						
	"{Sair}

Fechar o jogo."																						
																							
Novo jogo	Novo jogo																						
	"{Cenário simples}

Jogue um cenário para um jogador."																						
	"{Campanha}

Jogue uma campanha."																						
	"{Multijogadores}

Jogue um cenário para vários jogadores."																						
	"{Tutorial}

Jogue um cenário de tutorial que ensina o básico necessário para jogar Heroes III."																						
	"{Voltar}

Volta para a tela anterior."																						
																							
Seleção de um cenário simples	Seleção de um cenário simples																						
																							
SCENARIO_BACKGROUND 	Escolha um cenário																						
ADVANCED_BACKGROUND 	Definir opções avançadas																						
Background for random map menu	Customize and create a random map																						
SCENARIO_NAME 	Nome do cenário																						
Description Title	Mostra a descrição do cenário.																						
Description text	Mostra a descrição do cenário.																						
EASY 	"{Dificuldade fácil}

O jogador começa com uma larga vantagem em recursos e o computador joga mal."																						
NORMAL 	"{Dificuldade normal}

O jogador começa com uma moderada vantagem em recursos e o computador joga razoavelmente bem."																						
HARD 	"{Dificuldade difícil}

O jogador e o computador começam com a mesma quantidade de recursos e o computador joga da melhor forma que conseguir."																						
EXPERT 	"{Dificuldade expert}

O jogador começa com uma desvantagem de recursos e o computador joga da melhor forma que conseguir."																						
IMPOSSIBLE 	"{Dificuldade impossível}

O jogador começa sem recursos e o computador joga da melhor forma que conseguir."																						
ALLY_FLAG1 	Esta é a sua cor.																						
ALLY_FLAG2 	Esta cor está aliada contigo.																						
ALLY_FLAG3 	Esta cor está aliada contigo.																						
ALLY_FLAG4 	Esta cor está aliada contigo.
ALLY_FLAG5 	Esta cor está aliada contigo.
ALLY_FLAG6 	Esta cor está aliada contigo.
ALLY_FLAG7 	Esta cor está aliada contigo.
ALLY_FLAG8 	Esta cor está aliada contigo.
ENEMY_FLAG1 	Esta cor é sua inimiga.
ENEMY_FLAG2 	Esta cor é sua inimiga.
ENEMY_FLAG3 	Esta cor é sua inimiga.
ENEMY_FLAG4 	Esta cor é sua inimiga.
ENEMY_FLAG5 	Esta cor é sua inimiga.
ENEMY_FLAG6 	Esta cor é sua inimiga.
ENEMY_FLAG7 	Esta cor é sua inimiga.
ENEMY_FLAG8 	Esta cor é sua inimiga.
SCENARIO_OPTIONS 	Ver/ocultar a lista de cenários.
ADVANCED_OPTIONS 	Ver/ocultar as opções avançadas.
random map button	Jogar um mapa gerado aleatoriamente.
CHAT_DESC 	Toggle between Scenario Description and Chat Window
MAP_DIFFICULTY 	These allow you to modify the overall difficulty of the scenario
RATING 	Displays overall difficulty based on Map and Player difficulty settings
MAP_SIZE 	"A dificuldade do mapa pode ser fácil, normal, difícil, expert ou impossível."
VICTORY_CONDITION 	Condições de vitórias para este cenário.
LOSS_CONDITION 	Condições de derrota para este cenário.
SMALL_FILTER 	Ver todos os mapas pequenos.
MEDIUM_FILTER 	Ver todos os mapas médios.
LARGE_FILTER 	Ver todos os mapas grandes.
EXTRALARGE_FILTER 	Ver todos os mapas muito grandes.
ALL_FILTER 	Ver todos os mapas.
SCENARIO_NAME_1 	SCENARIO_NAME_1 
SCENARIO_NAME_2 	SCENARIO_NAME_2 
SCENARIO_NAME_3 	SCENARIO_NAME_3 
SCENARIO_NAME_4 	SCENARIO_NAME_4 
SCENARIO_NAME_5 	SCENARIO_NAME_5 
SCENARIO_NAME_6 	SCENARIO_NAME_6 
SCENARIO_NAME_7 	SCENARIO_NAME_7 
SCENARIO_NAME_8 	SCENARIO_NAME_8 
SCENARIO_NAME_9 	SCENARIO_NAME_9 
SCENARIO_NAME_10 	SCENARIO_NAME_10 
SCENARIO_NAME_11 	SCENARIO_NAME_11 
SCENARIO_NAME_12 	SCENARIO_NAME_12 
SCENARIO_NAME_13 	SCENARIO_NAME_13 
SCENARIO_NAME_14 	SCENARIO_NAME_14 
SCENARIO_NAME_15 	SCENARIO_NAME_15 
SCENARIO_NAME_16 	SCENARIO_NAME_16 
SCENARIO_NAME_17 	SCENARIO_NAME_17 
SCENARIO_NAME_18 	SCENARIO_NAME_18 
ENTRY_SCENARIO_NAME_1 	ENTRY_SCENARIO_NAME_1 
ENTRY_SCENARIO_NAME_2 	ENTRY_SCENARIO_NAME_2 
ENTRY_SCENARIO_NAME_3 	ENTRY_SCENARIO_NAME_3 
ENTRY_SCENARIO_NAME_4 	ENTRY_SCENARIO_NAME_4 
ENTRY_SCENARIO_NAME_5 	ENTRY_SCENARIO_NAME_5 
ENTRY_SCENARIO_NAME_6 	ENTRY_SCENARIO_NAME_6 
ENTRY_SCENARIO_NAME_7 	ENTRY_SCENARIO_NAME_7 
ENTRY_SCENARIO_NAME_8 	ENTRY_SCENARIO_NAME_8 
ENTRY_SCENARIO_NAME_9 	ENTRY_SCENARIO_NAME_9 
ENTRY_SCENARIO_NAME_10 	ENTRY_SCENARIO_NAME_10 
ENTRY_SCENARIO_NAME_11 	ENTRY_SCENARIO_NAME_11 
ENTRY_SCENARIO_NAME_12 	ENTRY_SCENARIO_NAME_12 
ENTRY_SCENARIO_NAME_13 	ENTRY_SCENARIO_NAME_13 
ENTRY_SCENARIO_NAME_14 	ENTRY_SCENARIO_NAME_14 
ENTRY_SCENARIO_NAME_15 	ENTRY_SCENARIO_NAME_15 
ENTRY_SCENARIO_NAME_16 	ENTRY_SCENARIO_NAME_16 
ENTRY_SCENARIO_NAME_17 	ENTRY_SCENARIO_NAME_17 
ENTRY_SCENARIO_NAME_18 	ENTRY_SCENARIO_NAME_18 
TURN_DURATION 	Duração da rodada
CHAT_TEXT 	Mensagens de chat						
CHAT_ENTRY 	CHAT_ENTRY 						
CHAT_PLUG 	CHAT_PLUG 						
CHAT_PLAYER 	Jogadores						
"CHAT_PLAYER_SLIDER,"	"CHAT_PLAYER_SLIDER,"						
ROLLOVER 	ROLLOVER 						
NEXT 	Salva o jogo selecionado.						
BEGIN 	Começa o cenário escolhido.						
BACK 	BACK 						
SSEXIT 	"Fechar esta janela.
(nenhuma ação será realizada)"						
WHICHMAP 	"Tamanho deste mapa.
(pequeno, médio, grande, muito grande, enorme, muito enorme ou gigante)"						
SORT_NUMBER 	Ordena os mapas pelo número de jogadores.						
SORT_SIZE 	Ordena os mapas pelo tamanho.						
k_sort_version	Ordena os mapas pela versão.						
SORT_ALPHA 	Ordena os mapas alfabeticamente pelo nome.						
SORT_VICTORY 	Ordena os mapas por condições de vitória.						
SORT_LOSS 	Ordena os mapas por condições de derrota.
BRIEFING 	BRIEFING 
SSHERO 	SSHERO 
GOLDPIC 	GOLDPIC 
HUMAN_CPU1 	Humano ou CPU significa que esta cor pode ser controlada tanto por um humano quanto por um computador.  Apenas CPU significa que apenas o computador pode controlar esta cor.
HUMAN_CPU2 	Humano ou CPU significa que esta cor pode ser controlada tanto por um humano quanto por um computador.  Apenas CPU significa que apenas o computador pode controlar esta cor.
HUMAN_CPU3 	Humano ou CPU significa que esta cor pode ser controlada tanto por um humano quanto por um computador.  Apenas CPU significa que apenas o computador pode controlar esta cor.
HUMAN_CPU4 	Humano ou CPU significa que esta cor pode ser controlada tanto por um humano quanto por um computador.  Apenas CPU significa que apenas o computador pode controlar esta cor.
HUMAN_CPU5 	Humano ou CPU significa que esta cor pode ser controlada tanto por um humano quanto por um computador.  Apenas CPU significa que apenas o computador pode controlar esta cor.
HUMAN_CPU6 	Humano ou CPU significa que esta cor pode ser controlada tanto por um humano quanto por um computador.  Apenas CPU significa que apenas o computador pode controlar esta cor.
HUMAN_CPU7 	Humano ou CPU significa que esta cor pode ser controlada tanto por um humano quanto por um computador.  Apenas CPU significa que apenas o computador pode controlar esta cor.
HUMAN_CPU8 	Humano ou CPU significa que esta cor pode ser controlada tanto por um humano quanto por um computador.  Apenas CPU significa que apenas o computador pode controlar esta cor.
HANDICAP1 	Permite a você dar uma desvantagem a este jogador ao reduzir seus recursos iniciais.
HANDICAP2 	Permite a você dar uma desvantagem a este jogador ao reduzir seus recursos iniciais.
HANDICAP3 	Permite a você dar uma desvantagem a este jogador ao reduzir seus recursos iniciais.
HANDICAP4 	Permite a você dar uma desvantagem a este jogador ao reduzir seus recursos iniciais.
HANDICAP5 	Permite a você dar uma desvantagem a este jogador ao reduzir seus recursos iniciais.
HANDICAP6 	Permite a você dar uma desvantagem a este jogador ao reduzir seus recursos iniciais.
HANDICAP7 	Permite a você dar uma desvantagem a este jogador ao reduzir seus recursos iniciais.
HANDICAP8 	Permite a você dar uma desvantagem a este jogador ao reduzir seus recursos iniciais.
TOWN_LEFT1 	Permite a você escolher uma facção inicial.
TOWN_LEFT2 	Permite a você escolher uma facção inicial.
TOWN_LEFT3 	Permite a você escolher uma facção inicial.
TOWN_LEFT4 	Permite a você escolher uma facção inicial.
TOWN_LEFT5 	Permite a você escolher uma facção inicial.
TOWN_LEFT6 	Permite a você escolher uma facção inicial.
TOWN_LEFT7 	Permite a você escolher uma facção inicial.
TOWN_LEFT8 	Permite a você escolher uma facção inicial.
TOWN_RITE1 	Permite a você escolher uma facção inicial.
TOWN_RITE2 	Permite a você escolher uma facção inicial.
TOWN_RITE3 	Permite a você escolher uma facção inicial.
TOWN_RITE4 	Permite a você escolher uma facção inicial.
TOWN_RITE5 	Permite a você escolher uma facção inicial.
TOWN_RITE6 	Permite a você escolher uma facção inicial.
TOWN_RITE7 	Permite a você escolher uma facção inicial.
TOWN_RITE8 	Permite a você escolher uma facção inicial.
HERO_LEFT1 	Permite a você escolher o herói inicial baseado na sua facção.
HERO_LEFT2 	Permite a você escolher o herói inicial baseado na sua facção.
HERO_LEFT3 	Permite a você escolher o herói inicial baseado na sua facção.
HERO_LEFT4 	Permite a você escolher o herói inicial baseado na sua facção.
HERO_LEFT5 	Permite a você escolher o herói inicial baseado na sua facção.
HERO_LEFT6 	Permite a você escolher o herói inicial baseado na sua facção.
HERO_LEFT7 	Permite a você escolher o herói inicial baseado na sua facção.
HERO_LEFT8 	Permite a você escolher o herói inicial baseado na sua facção.
HERO_RITE1 	Permite a você escolher o herói inicial baseado na sua facção.
HERO_RITE2 	Permite a você escolher o herói inicial baseado na sua facção.
HERO_RITE3 	Permite a você escolher o herói inicial baseado na sua facção.
HERO_RITE4 	Permite a você escolher o herói inicial baseado na sua facção.
HERO_RITE5 	Permite a você escolher o herói inicial baseado na sua facção.
HERO_RITE6 	Permite a você escolher o herói inicial baseado na sua facção.
HERO_RITE7 	Permite a você escolher o herói inicial baseado na sua facção.
HERO_RITE8 	Permite a você escolher o herói inicial baseado na sua facção.
RES_LEFT1 	Permite a você escolher o bônus inicial para o seu herói.
RES_LEFT2 	Permite a você escolher o bônus inicial para o seu herói.
RES_LEFT3 	Permite a você escolher o bônus inicial para o seu herói.
RES_LEFT4 	Permite a você escolher o bônus inicial para o seu herói.
RES_LEFT5 	Permite a você escolher o bônus inicial para o seu herói.
RES_LEFT6 	Permite a você escolher o bônus inicial para o seu herói.
RES_LEFT7 	Permite a você escolher o bônus inicial para o seu herói.
RES_LEFT8 	Permite a você escolher o bônus inicial para o seu herói.
RES_RITE1 	Permite a você escolher o bônus inicial para o seu herói.
RES_RITE2 	Permite a você escolher o bônus inicial para o seu herói.
RES_RITE3 	Permite a você escolher o bônus inicial para o seu herói.
RES_RITE4 	Permite a você escolher o bônus inicial para o seu herói.
RES_RITE5 	Permite a você escolher o bônus inicial para o seu herói.
RES_RITE6 	Permite a você escolher o bônus inicial para o seu herói.
RES_RITE7 	Permite a você escolher o bônus inicial para o seu herói.
RES_RITE8 	Permite a você escolher o bônus inicial para o seu herói.
HERO_SETTING_1 	Clique aqui para jogar com esta cor.
HERO_SETTING_2 	Clique aqui para jogar com esta cor.
HERO_SETTING_3 	Clique aqui para jogar com esta cor.
HERO_SETTING_4 	Clique aqui para jogar com esta cor.
HERO_SETTING_5 	Clique aqui para jogar com esta cor.
HERO_SETTING_6 	Clique aqui para jogar com esta cor.
HERO_SETTING_7 	Clique aqui para jogar com esta cor.
HERO_SETTING_8 	Clique aqui para jogar com esta cor.
TOWN_SETTING_1 	TOWN_SETTING_1 
TOWN_SETTING_2 	TOWN_SETTING_2 
TOWN_SETTING_3 	TOWN_SETTING_3 
TOWN_SETTING_4 	TOWN_SETTING_4 
TOWN_SETTING_5 	TOWN_SETTING_5 	
TOWN_SETTING_6 	TOWN_SETTING_6 	
TOWN_SETTING_7 	TOWN_SETTING_7 	
TOWN_SETTING_8 	TOWN_SETTING_8 	
"const_create_map,"		
"const_map_size_label,"	Escolha o tamanho do mapa.	
"const_small_map,"	Criar um mapa pequeno.	
"const_medium_map,"	Criar um mapa médio.	
"const_large_map,"	Criar um mapa grande.	
"const_huge_map,"	Criar um mapa muito grande.	
"const_map_levels,"	Escolhe se o mapa tem um ou dois planos.	
"const_human_positions_label,"	Selecione o número de posições jogáveis por humanos.	
"const_1_human,"	Criar 1 jogador humano ou computador.	
"const_2_humans,"	Criar 2 jogadores humanos ou computador.	
"const_3_humans,"	Criar 3 jogadores humanos ou computador.	
"const_4_humans,"	Criar 4 jogadores humanos ou computador.	
"const_5_humans,"	Criar 5 jogadores humanos ou computador.	
"const_6_humans,"	Criar 6 jogadores humanos ou computador.	
"const_7_humans,"	Criar 7 jogadores humanos ou computador.	
"const_8_humans,"	Criar 8 jogadores humanos ou computador.	
"const_random_humans,"	Criar 1-8 jogadores humanos.	
"const_human_teams_label,"	Selecione o número de times para posições jogáveis por humanos.	
"const_no_human_teams,"	Sem times.	
"const_1_human_team,"	Criar 1 time humano.	
"const_2_human_teams,"	Criar 2 times humanos.	
"const_3_human_teams,"	Criar 3 times humanos.	
"const_4_human_teams,"	Criar 4 times humanos.	
"const_5_human_teams,"	Criar 5 times humanos.	
"const_6_human_teams,"	Criar 6 times humanos.	
"const_7_human_teams,"	Criar 7 times humanos.	
"const_random_human_teams,"	Criar um número aleatório de times humanos.	
"const_computer_positions_label,"	Selecione o número de posições apenas para o computador.	
"const_no_computers,"	Não criar jogadores computadores.	
"const_1_computer,"	Criar 1 jogador computador.	
"const_2_computers,"	Criar 2 jogadores computador.	
"const_3_computers,"	Criar 3 jogadores computador.	
"const_4_computers,"	Criar 4 jogadores computador.	
"const_5_computers,"	Criar 5 jogadores computador.	
"const_6_computers,"	Criar 6 jogadores computador.	
"const_7_computers,"	Criar 7 jogadores computador.	
"const_random_computers,"	Criar um número aleatório de posições para o computador.	
"const_computer_teams_label,"	Selecione o número de times de computadores.	
"const_no_computer_teams,"	Sem times de computdor.	
"const_1_computer_team,"	Criar 1 time de computador.	
"const_2_computer_teams,"	Criar 2 times de computador.	
"const_3_computer_teams,"	Criar 3 times de computador.	
"const_4_computer_teams,"	Criar 4 times de computador.	
"const_5_computer_teams,"	Criar 5 times de computador.	
"const_6_computer_teams,"	Criar 6 times de computador.	
"const_random_computer_teams,"	Criar um número aleatório de times de computadores.	
"const_water_label,"	Selecione a quntidade de água no mapa.	
"const_no_water,"	Sem água ou quase.	
"const_normal_water,"	Cria um continente cercado de água.	
"const_islands,"	Cria pequenas massas de terra como ilhas cercadas de água.	
"const_random_water,"	Escolhe uma quantidade aleatória de água.	
"const_monster_strength_label,"	Selecione a força relativa dos monstros guardiões.	
"const_weak_monsters,"	Faça os monstros srem mais fracos que o normal.	
"const_normal_monsters,"	Guardiões com força normal.	
"const_strong_monsters,"	Criar guardiões fortes.	
"const_random_monsters,"	Escolher aleatoriamente a força dos monstros guardiões.	
"const_show_saved_random_maps,"	Mostrar os mapas aleatórios gerdos recentemente.	
SLIDER_CHATWINDOW 	Scroll through chat text	
SLIDER_FILEMENU 	Scroll through scenario or save game list	
SLIDER_DURATION 	Allows you to change player turn duration	
"PLAYER_HANDICAP_HEADER_ID,"	"{Player Name / Handicap Type}

Each potential slot a human player can occupy is marked with an adjacent banner.  Click the banner to change position.  You may also click inside the name field to change your player name.

Each player may be 'handicapped' by clicking the 'handicap' button.  There are three settings: No Handicap, Mild Handicap, and Severe Handicap.  Mild and Severe diminish a player's starting resources.
"																						
"TURN_DURATION_HEADER_ID,"	"{Player Turn Duration}

Using the slider, you may set 'soft' player turn durations.  By 'soft', a timer counts down a player's turn when not in combat.  When in combat, the timer is paused.

Turn durations are 1, 2, 4, 6, 8, 10, 15, 20, 25, and 30 minutes.
'Unlimited' is the default setting.
"																						
"STARTING_TOWN_HEADER_ID,"	"{Facção inicial}

Cada jogador pode ou não começar com uma cidade.  As opções são aleatório, castelo, floresta, torre, inferno, necrópolis, masmorra, barbárie e pântano.

Quando você inicia sem uma cidade, estas definições podem ser usadas para escolher a facção de um possível herói inicial.
"																						
"STARTING_TOWN_HEADER_W_CONFLUX_ID,"	"{Facção inicial}

Cada jogador pode ou não começar com uma cidade.  As opções são aleatório, castelo, floresta, torre, inferno, necrópolis, masmorra, barbárie, pântano, confluxo e enseada.

Quando você inicia sem uma cidade, estas definições podem ser usadas para escolher a facção de um possível herói inicial.
"																						
"STARTING_HERO_HEADER_ID,"	"{Herói inicial}

Cada jogador pode ou não começar com um herói.  Às vezes, est opção pode estar travada ou ausente.  Em outras circunstâncias, você pode rodar por escolhas de até 16 heróis diferentes.  Se a opção da sua facção inicial estiver habilitada, você pode trocr as classes de heróis por um conjunto diferentes de heróis a escolher.

Para ver o nome, classe e especialidade de um herói, clique em sua foto.
"																						
"STARTING_BONUS_HEADER_ID,"	"{Bônus inicial}

Com um bônus inicial, você pode começar com um artefato aleatório, 500-1000 ouros, ou 5-10 unidades de madeira e de pedra.
"																						
																							
Multiplayer Selection	Multiplayer Selection																						
																							
Online Service	"{Online Service}

Allows you to play over an Online Service"																						
Hot Seat	"{Hot Seat}

Allows multiple people to play different players on the same computer"																						
IPX	"{IPX}

Allows multiple people to play on their own computers across a local area network"																						
TCP/IP	"{TCP/IP}

Allows multiple people to play on their own computers across a local area network or via the internet"																						
Modem	"{Modem}

Allows two people to connect via modem"																						
Direct Connect	"{Direct Connect}

Allows two people to connect via a direct serial connection"																						
Host a Game	"{Host Game}

Allows you to set up and create the game that others will join"																						
Join a Game	"{Join Game}

Displays a list of available games for you to join"
Search for a Game	"{Search for Game}

Allows you to enter a specific IP address to connect to"
GAMENAME 1	GAMENAME 1
GAMENAME 2	GAMENAME 2
GAMENAME 3	GAMENAME 3
GAMENAME 4	GAMENAME 4
GAMENAME 5	GAMENAME 5
GAMENAME 6	GAMENAME 6
GAMENAME 7	GAMENAME 7
GAMENAME 8	GAMENAME 8
GAMENAME 9	GAMENAME 9
GAMENAME 10	GAMENAME 10
GAMENAME 11	GAMENAME 11
GAMENAME 12	GAMENAME 12
Scroll through available games	Scroll through available games
	
Cancelar	Volta ao menu anterior																						
																							
Adventure Map Window																							
World Map	"This is a zoomed out view of the world.  Clicking anywhere in this window will center the adventure map on that location, or you can drag the outline box to scroll the adventure map."																						
Status Window	{Status Window}

This window provides information on the status of your hero or kingdom, and shows the date.  Left click here to cycle through these windows.																						
Kingdom Overview	"{Kingdom Overview}

Displays an overview of your Kingdom's towns and heroes"																						
Surface/Underworld View	"{Surface/Underworld View}

Switches the adventure map between map levels"																						
Quest Log	"{Quest Log}

Displays a list of all current quests"																						
Sleep/Wake Hero	"{Sleep/Wake Hero}

Sleeps the selected hero or wakes a sleeping hero.  Any sleeping heroes will be ignored by the Next Hero button."																						
Move Hero	"{Move Hero}

Moves the current hero along its selected path"																						
Conjurar feitiço	"{Conjurar feitiço}

Conjura um feitiço de aventura"																						
Adventure Options	"{Adventure Options}

Allows you to dig for the Grail, view the current Grail Puzzle, World Map, or Scenario Briefing.  In multiplayer games you will also be allowed to view your opponents' last turn."																						
Opções de sistema	"{Opções de sistema}

Allows you to view and change the current game options"																						
Próximo herói	"{Próximo herói}

Selects the next hero with remaining movement points.  Any sleeping heroes will be ignored."																						
Fim da rodada	"{Fim da rodada}

Ends the current turn"																						
Scroll Hero List	"{Scroll Hero List}

Scroll up through available heroes"																						
Scroll Hero List	"{Scroll Hero List}

Scroll down through available heroes"																						
Retrato do herói	"{Retrato do herói}

Click once to select this hero and center the adventure map on their location.  Click again to enter and view the Hero Screen."																						
Scroll Town List	"{Scroll Town List}

Scroll up through available towns"																						
Scroll Town List	"{Scroll Town List}

Scroll down through available towns"																						
Town Portrait	"{Town Portrait}

Click once to select this town and center the adventure map on its location.  Click again to enter and view the Town Screen."																						
Ouro	Quantidade de ouro dentre seus tesouros.																						
Madeira	Sua quantidade total de madeira.																						
Mercúrio	Sua quantidade total de mercúrio.																						
Pedra	Sua quantidade total de pedra.																						
Enxofre	Sua quantidade total de enxofre.																						
Cristais	Sua quantidade total de cristatis.																						
Gemas	Sua quantidade total de gemas.																						
Data	"{Data}

Mês, semana e dia atual"																						
ROLLOVER	ROLLOVER																						
																							
System Options	System Options																						
Menu principal	"{Menu principal}

Abandonar o jogo e voltar ao menu principal."
Carregar jogo	"{Carregar jogo}

Carregar um jogo salvo."
Salvar jogo	"{Salvar jogo}

Salvr o jogo atual."
Recomeçar o cenário	"{Recomeçar o cenário}

Recomeça o jogo neste mesmo cenário."
Sair do jogo	"{Sair do jogo}

Sair do Heroes of Might and Magic III."
Voltar	"{Voltar ao jogo}

Return to the Adventure Map!"
"MUSIC_VOLUME_0_ID,"	Desliga a música.
"MUSIC_VOLUME_1_ID,"	Define o volume da música em 1.
"MUSIC_VOLUME_2_ID,"	Define o volume da música em 2.
"MUSIC_VOLUME_3_ID,"	Define o volume da música em 3.
"MUSIC_VOLUME_4_ID,"	Define o volume da música em 4.
"MUSIC_VOLUME_5_ID,"	Define o volume da música em 5.
"MUSIC_VOLUME_6_ID,"	Define o volume da música em 6.
"MUSIC_VOLUME_7_ID,"	Define o volume da música em 7.
"MUSIC_VOLUME_8_ID,"	Define o volume da música em 8.
"MUSIC_VOLUME_9_ID,"	Define o volume da música em 9.
"EFFECTS_VOLUME_0_ID,"	Desliga os efeitos sonoros.
"EFFECTS_VOLUME_1_ID,"	Define o volume dos efeitos sonoros em 1.
"EFFECTS_VOLUME_2_ID,"	Define o volume dos efeitos sonoros em 2.
"EFFECTS_VOLUME_3_ID,"	Define o volume dos efeitos sonoros em 3.
"EFFECTS_VOLUME_4_ID,"	Define o volume dos efeitos sonoros em 4.
"EFFECTS_VOLUME_5_ID,"	Define o volume dos efeitos sonoros em 5.
"EFFECTS_VOLUME_6_ID,"	Define o volume dos efeitos sonoros em 6.
"EFFECTS_VOLUME_7_ID,"	Define o volume dos efeitos sonoros em 7.
"EFFECTS_VOLUME_8_ID,"	Define o volume dos efeitos sonoros em 8.
"EFFECTS_VOLUME_9_ID,"	Define o volume dos efeitos sonoros em 9.
"MUSIC_TYPE_NONE_ID,"	"MUSIC_TYPE_NONE_ID,"
"MUSIC_TYPE_CD_ID,"	"MUSIC_TYPE_CD_ID,"
"MUSIC_TYPE_MIDI_ID,"	"MUSIC_TYPE_MIDI_ID,"
"HERO_SPEED_WALK_ID,"	"Define a velocidade do herói como andar.
(mais lento)"
"HERO_SPEED_CANTER_ID,"	Define a velocidade do herói como trotar.
"HERO_SPEED_GALLOP_ID,"	Define a velocidade do herói como galopar.
"HERO_SPEED_JUMP_ID,"	"Define a velocidade do herói como pular.
(sem animação - mais rápido)"
"AI_SPEED_CANTER_ID,"	"Define a velocidade do inimigo como trotar.
(mais lento)"
"AI_SPEED_GALLOP_ID,"	Define a velocidade do inimigo como galopar.
"AI_SPEED_JUMP_ID,"	"Define a velocidade do inimigo como pular.
(sem animação - mais rápido)"
"AI_SPEED_NONE_ID,"	Do not show enemy movement
"WINDOW_SCROLL_SLOW,"	Definir a velocidade da animação para lento.
"WINDOW_SCROLL_MEDIUM,"	Definir a velocidade da animação para médio.
"WINDOW_SCROLL_FAST,"	Definir a velocidade da animação para rápido.
"SHOW_PATH_ID,"	"{Show Move Path}

When checked, will display a hero's movement path without moving the hero."
"MOVE_REMINDER_ID,"	"{Show Hero Reminder}

When a player has any heroes with movement points remaining, they will asked to confirm an End Turn order."
"QUICK_COMBAT_ID,"	"{Quick Combat}

This option allows the computer to handle all combat calculations, and the player will only be shown the Combat Results screen."
"VIDEO_SUBTITLES_ID,"	"{Video Subtitles}

This option will display subtitles on any of the animated cutscenes."
VIDEO_QUALITY_LOW	"{Low Quality Video}

This option is reccommended for slower computers which have difficulty running the videos at full screen."
VIDEO_QUALITY_HIGH	"{High Quality Video}

Faster machines can handle more data, and this this option allows those machines to view the videos at their highest quality."
"TOWN_OUTLINES_ID,"	"{Town Outlines}

In the town screen, any accessible building will display an outline when the mouse cursor is placed over it."
"ANIMATE_SPELLBOOK_ID,"	"{Animate Spell Book}

Shows page turning animation in the spell book."
																							
Adventure Options																							
View World	"{View World}

See a bird's eye view of the world"																						
View Puzzle	"{View Puzzle}

See the map of the buried object"																						
View Scenario Info	"{View Scenario Info}

View information about the current scenario"																						
Cavar	"{Cavar}

Search the area for the buried Grail"																						
Replay Opponent Turn	"{Replay Opponent Turn}

Replays events since your last turn"																						
ROLLOVER	ROLLOVER																						
Ok	"{Ok}

Return to the Adventure Map"																						
																							
Combat Window	Combat Window																						
Render-se	"{Render-se}

Ofereça uma rendição ao inimigo.  O seu herói deve pagar para sair do combate, mas imediatamente poderá ser recrutado na taverna junto com todas as tropas e artefatos que estiverem em sua posse."																						
Fugir	"{Fugir}

O seu herói fugirá do combate, mas imediatamente poderá ser recrutado na taverna junto com todos os artefatos que estiverem em sua posse."																						
Opções de combate	"{Opções de combate}

Allows you to view or change the current combat options"																						
Auto Combat	"{Auto Combat}

Allows the computer to conduct the combat for you.  Click anywhere during auto combat to take control of your own troops.  You will be given control on your next unit's move phase."																						
	Combat text appears in this window																						
	Scroll through text displayed during combat																						
Conjurar feitiço	"{Conjurar feitiço}

Abre o livro de magia do seu herói, permitindo a você conjurar um feitiço."																						
Esperar	"{Esperar}

Delay this unit's turn until after all troops have had the opportunity to move"																						
Defender	"{Defender}

Increases this unit's defense value by sacrificing its move this turn"																						
Phase Wait	Phase Wait																						
End Tactics Phase	"{End Tactics Phase}

Ends the Tactics Phase and commences combat."																						
																							
Opções de combate	Opções de combate																						
Voltar ao combate	"{Voltar ao combate}

Exit combat options"																						
Restore Default Values	"{Default}

Restores combat option default values"																						
"MUSIC_VOLUME_0_ID,"	Desliga a música.																						
"MUSIC_VOLUME_1_ID,"	Define o volume da música em 1.																						
"MUSIC_VOLUME_2_ID,"	Define o volume da música em 2.																						
"MUSIC_VOLUME_3_ID,"	Define o volume da música em 3.																						
"MUSIC_VOLUME_4_ID,"	Define o volume da música em 4.																						
"MUSIC_VOLUME_5_ID,"	Define o volume da música em 5.																						
"MUSIC_VOLUME_6_ID,"	Define o volume da música em 6.
"MUSIC_VOLUME_7_ID,"	Define o volume da música em 7.
"MUSIC_VOLUME_8_ID,"	Define o volume da música em 8.
"MUSIC_VOLUME_9_ID,"	Define o volume da música em 9.
"EFFECTS_VOLUME_0_ID,"	Desliga os efeitos sonoros.
"EFFECTS_VOLUME_1_ID,"	Define o volume dos efeitos sonoros em 1.
"EFFECTS_VOLUME_2_ID,"	Define o volume dos efeitos sonoros em 2.
"EFFECTS_VOLUME_3_ID,"	Define o volume dos efeitos sonoros em 3.
"EFFECTS_VOLUME_4_ID,"	Define o volume dos efeitos sonoros em 4.
"EFFECTS_VOLUME_5_ID,"	Define o volume dos efeitos sonoros em 5.
"EFFECTS_VOLUME_6_ID,"	Define o volume dos efeitos sonoros em 6.
"EFFECTS_VOLUME_7_ID,"	Define o volume dos efeitos sonoros em 7.
"EFFECTS_VOLUME_8_ID,"	Define o volume dos efeitos sonoros em 8.
"EFFECTS_VOLUME_9_ID,"	Define o volume dos efeitos sonoros em 9.
"MUSIC_TYPE_NONE_ID,"	"MUSIC_TYPE_NONE_ID,"
"MUSIC_TYPE_CD_ID,"	"MUSIC_TYPE_CD_ID,"
"MUSIC_TYPE_MIDI_ID,"	"MUSIC_TYPE_MIDI_ID,"
"AUTO_CREATURES_ID,"	"{Criaturas}

Gives control of your units to auto combat"
"AUTO_SPELLS_ID,"	"{Feitiços}

During auto combat your hero will cast spells"
"AUTO_CATAPULT_ID,"	"{Catapulta}

When laying siege to an enemy's castle, your catapult troops will decide which part of the fortifications to target.  If your Ballistics skill is high enough, you will be able to direct the catapult's fire yourself.

If your hero has the Ballistics skill, this option will give that control to the computer during auto combat."
"AUTO_BALLISTA_ID,"	"{Assault battle machine}

During combat, your assault machine troops will decide which  enemy units to target.  If your Artillery skill is high enough, you will be able to direct the assault machine's fire yourself.

If your hero has the Artillery skill, this option will give that control to the computer during auto combat."
"AUTO_FIRST_AID_TENT_ID,"	"{Tenda médica}

During combat, your first aid troops will choose who needs to be healed.  If your First Aid skill is high enough, you will be able to direct the first aid tent yourself.

If your hero has the First Aid skill, this option will give that control to the computer during auto combat."
"ANIMATION_SPEED_0_ID,"	Definir a velocidade da animação para lento.
"ANIMATION_SPEED_1_ID,"	Definir a velocidade da animação para médio.
"ANIMATION_SPEED_2_ID,"	Definir a velocidade da animação para rápido.
"CREATURE_INFO_STATS_ID,"	"{All Statistics}

Right clicking on a unit will display all statistics about the unit, including any spells that are currently in effect."
"CREATURE_INFO_SPELLS_ID,"	"{Spells Only}

Right clicking on a unit will only display any spells that are currently affecting the unit."
"VIEW_HEX_ID,"	"{View Hex Grid}

Displays a hex grid over the battlefield."
"MOVEMENT_SHADOW_ID,"	"{Movement Shadow}

Displays a shadow on the battlefield which shows where a unit can currently move to."
"SHADOW_CURSOR_ID,"	"{Cursor Shadow}

Places a hex shadow under the mouse cursor."
"ANIMATE_SPELLBOOK_ID,"	"{Animate Spell Book}

Shows page turning animation in the spell book."
	
Ver o exército	Ver o exército																						
Nome da criatura	Nome da criatura																						
Número de criaturas	Número de criaturas na unidade																						
Ataque	Ataque																						
Defesa	Defesa																						
Tiros restantes	Número de tiross restantes																						
Dano por ataque	Dano por ataque																						
Vitalidade	Vitalidade																						
Vitalidade restante	Vitalidade restante																						
Velocidade	Velocidade																						
Moral	Moral																						
Sorte	Sorte																						
Feitiços afetando a tropa	Feitiços afetando a tropa																						
Demitir unidade	"{Demitir unidade}

Demite a unidade selecionada do seu exército."																						
Melhorar unidade	"{Melhorar unidade}

Melhora a unidade selecionada."																						
Ok	"{Ok}

Voltar à janela anterior."																						
																							
Livro de magia	Livro de magia																						
Página anterior	Virar a página anterior																						
Próxima página	Virar a página seguinte																						
Feitiços de aventura	Visualize feitiços de aventura																						
Feitiços de combate	Visualize feitiços de combate																						
Feitiços de ar	Visualize feitiços de ar																						
Feitiços de fogo	Visualize feitiços de fogo																						
Feitiços de água	Visualize feitiços de água																						
Feitiços de terra	Visualize feitiços de terra																						
Todos os feitiços	Visualize todos os feitiços																						
Pontos de magia	Pontos de magia restantes																						
Sair	Fecha o livro de magia																						
																							
CampaignBrief	CampaignBrief																						
																							
CAMPAIGN_NAME	CAMPAIGN_NAME
CAMPAIGN_DESCRIPTION	CAMPAIGN_DESCRIPTION
MAP_NAME	MAP_NAME
MAP_DESCRIPTION	MAP_DESCRIPTION
HERO_FACE	HERO_FACE
Trocar herói	Clique para trocar o seu herói inicial.
Trocar herói	Clique para trocar o seu herói inicial.
Bônus de artefato	Escolha iniciar com um artefato.
Bônus de ouro	Escolha iniciar com mais ouro.
Bônus de recurso	Escolha iniciar com mais recursos.
Recomeçar	"{Recomeçar}

Restart the current campaign"
View Campaign Intro	"{View Campaign Intro}

Show the intro movie for this campaign"
ALLY_FLAG1_ID	Esta é a sua cor.
ALLY_FLAG2_ID	Esta cor está aliada contigo.
ALLY_FLAG3_ID	Esta cor está aliada contigo.
ALLY_FLAG4_ID	Esta cor está aliada contigo.
ALLY_FLAG5_ID	Esta cor está aliada contigo.
ALLY_FLAG6_ID	Esta cor está aliada contigo.
ALLY_FLAG7_ID	Esta cor está aliada contigo.
ALLY_FLAG8_ID	Esta cor está aliada contigo.
ENEMY_FLAG1_ID	Esta cor é sua inimiga.
ENEMY_FLAG2_ID	Esta cor é sua inimiga.
ENEMY_FLAG3_ID	Esta cor é sua inimiga.
ENEMY_FLAG4_ID	Esta cor é sua inimiga.
ENEMY_FLAG5_ID	Esta cor é sua inimiga.
ENEMY_FLAG6_ID	Esta cor é sua inimiga.
ENEMY_FLAG7_ID	Esta cor é sua inimiga.
ENEMY_FLAG8_ID	Esta cor é sua inimiga.
WHICHMAP_ID	Este é o tamanho do mapa que você está prestes a jogar.
MAP_AREA_1	MAP_AREA_1
MAP_AREA_2	MAP_AREA_2
MAP_AREA_3	MAP_AREA_3
MAP_AREA_4	MAP_AREA_4
MAP_AREA_5	MAP_AREA_5
MAP_AREA_6	MAP_AREA_6
MAP_AREA_7	MAP_AREA_7
MAP_AREA_8	MAP_AREA_8
MAP_AREA_9	MAP_AREA_9
MAP_AREA_10	MAP_AREA_10
MAP_AREA_11	MAP_AREA_11
MAP_AREA_12	MAP_AREA_12
MAP_AREA_13	MAP_AREA_13
MAP_AREA_14	MAP_AREA_14
MAP_AREA_15	MAP_AREA_15
MAP_AREA_16	MAP_AREA_16
MAP_AREA_17	MAP_AREA_17
MAP_AREA_18	MAP_AREA_18
MAP_AREA_19	MAP_AREA_19
MAP_AREA_20	MAP_AREA_20																						
MAP_AREA_21	MAP_AREA_21																						
MAP_AREA_22	MAP_AREA_22																						
MAP_AREA_23	MAP_AREA_23																						
MAP_AREA_24	MAP_AREA_24																						
MAP_AREA_25	MAP_AREA_25																						
MAP_AREA_26	MAP_AREA_26																						
MAP_AREA_27	MAP_AREA_27																						
MAP_AREA_28	MAP_AREA_28																						
MAP_AREA_29	MAP_AREA_29																						
MAP_AREA_30	MAP_AREA_30																						
MAP_AREA_31	MAP_AREA_31																						
MAP_AREA_32	MAP_AREA_32																						
																							
CampaignWindow	CampaignWindow																						
																							
Long Live the Queen	Long Live the Queen		
Liberation	Liberation		
Spoils of War	Spoils of War		
Song for the Father	Song for the Father		
Dungeons and Devils	Dungeons and Devils		
Long Live the King	Long Live the King		
Seeds of Discontent	Seeds of Discontent		
Armageddon's Blade	Armageddon's Blade		
Dragon's Blood	Dragon's Blood		
Dragon Slayer	Dragon Slayer		
Festival of Life	Festival of Life		
Foolhardy Waywardness	Foolhardy Waywardness		
Playing With Fire	Playing With Fire		
Horn of the Abyss	Horn of the Abyss		
Birth of a Barbarian	Birth of a Barbarian		
Under the Jolly Roger	Under the Jolly Roger		
Terror of the Seas	Terror of the Seas																						
Rise of the Necromancer	Rise of the Necromancer																						
Unholy Alliance	Unholy Alliance																						
Spectre of Power	Spectre of Power																						
																							
																							
ROLLOVER	ROLLOVER																						
																							
Recrutar	Recrutar																						
Máximo																							
Recrutar																							
Cancelar																							
																							
Multiplayer	Multiplayer																						
Check Box	Click this to enable/disable name																						
Enter Player Name	Enter Player Name																						
OK																							
Voltar																							
Enter Session Name																							
Enter Password																							
Session Name																							
Enter IP Address																							
																							
Sacrifice Window	Sacrifice Window																						
Sair (nada será sacrificado).	Leave the Altar.  All items currently on the Altar will be returned to you.																						
Currently held artifact																							
Place all artifacts in backpack on altar	Move items in your hero's backpack on to the Altar.																						
Place all artifacts on the altar	"Move all artifacts, both equipped and in your hero's backpack, on to the Altar."																						
Sacrifice creatures	Switch to Sacrifice Creatures.  Only available for Evil and Neutral heroes.																						
Number of creatures / Experience value																							
Currently selected creatures																							
Number of creatures / Experience value																							
Number of creatures to sacrifice																							
Set number of creatures to sacrifice																							
Sacrifice maximum number of creatures	Move the maximum number of creatures on to the Altar.																						
Sacrifice all creatures in your hero's army	Move all but one creature on to the Altar.																						
Sacrifice artifacts	Switch to Sacrifice Artifacts screen.  Only available for Good and Neutral heroes.																						
Number of creatures / Experience value																							
Place artifact to sacrifice here																							
Experience value of artifact																							
Sacrifice artifacts currently on the altar	"Sacrifice anything currently on the Altar, and gain experience."																						
Sacrifice creatures currently on the altar	"Sacrifice anything currently on the Altar, and gain experience."																						
	Search through backpack																						
	Search through backpack																						
																							
Transformador de esqueletos	Transformador de esqueletos																						
Place all creatures in the transformer	Move all creatures into the transformer																						
Change creatures in the transformer into undead	Change creatures in the Transformer into undead																						
Exit transfomer	Leave the transformer.  No more creatures will become undead																						
																							
Trade Window	Trade Window																						
Fazer negócio																							
Máximo																							
Dar recursos para outro jogador																							
Comprar artefatos																							
Vender criaturas																							
Sair																							
																							
Give Resource Window	Give Resource Window																						
Fazer negócio																							
Máximo																							
Trocar recursos																							
Comprar artefatos																							
Sair																							
																							
Buy Artifact Window	Buy Artifact Window																						
Fazer negócio																							
Trocar recursos																							
Dar recursos para outro jogador																							
Vender artefatos																							
Sair																							
																							
Sell Artifact Window	Sell Artifact Window																						
Fazer negócio																							
Trocar recursos																							
Dar recursos para outro jogador																							
Comprar artefatos																							
Sair																							
																							
Sell Creature Window	Sell Creature Window																						
Fazer negócio																							
Máximo																							
Trocar recursos																							
Dar recursos para outro jogador																							
Sair																							
																							
University Window	University Window																						
Cancelar	Voltar à escolha de habilidade																						
Sair da universidade	Sair da universidade																						
	Aprender %s %s por %d ouros.																						
Not used...  filthy bug.																							
Insert all data before this line. Do not alter or delete this line.																							



																							
